7
9
S S S S S S S S S
S S S X X X S S S
S S X X X X X S S
S X X X S X X X S
S S X X X X X S S
S S S X X X S S S
S S S S S S S S S